1111111111111111111111
1P0000C0000X0000C00E01
1111011101110111011101
1C0000X0000C0000000001
1011101110111011101001
1C0000C0000X0000C00001
1011101110111011101001
1C0000C0000X0000C00001
1111111111111111111111
