111111111111
1P0XC0X0X1E1
10101101C111
10CX00C00001
1C000C000001
111111111111