111111111111
1P0XC00000E1
10101101C101
10C000C00001
1C000C000001
111111111111