111111111111111111111
1P0000C0000X0000C00E1
111101110111011101111
1C0000X0000C000000001
101110111011101110101
1C0000C0000X0000C0001
111111111111111111111
