111111111111
1P00C00000E1
101011011101
100000C00001
100000000001
111111111111