111111111111111111111
1P0000C000000000C00E1
111101110111011101111
1C000000000C000000001
101110111011101110101
1C0000C000000000C0001
111111111111111111111
