1111111
1P0C0E1
111C001
1X000X1
1111111