111111111111
1P0XC000X0E1
10101101C101
10CX00C00001
1C000C000001
111111111111