1111111
1P0C0E1
111CC11
1X000X1
1111111