111111111111
1P0XC0000001
10101101C111
10C000C001E1
1C000C000111
111111111111
