111111111111
1P0XC00000E1
10101101C111
10C000C001C1
1C000C000111
111111111111
